1111111
1000001
1P0C0E1
1000001
1111111